15,28
%%%%%%%%%%%%%%%%%%%%%%%%%%%%
%...%.....%.......%........%
%......%....%.......%%%....%
%..%%..%%......%......%....e
%%%%%.%%%.%%%.....%...%%...%
%......%%....%...%.......%.%
%..%%%%.....%....%....%%%..%
%.....%%....%%...%%%%....%%%
%..%%%%%%%....%.%.%........%
%...............%..........%
%%%%%.......%...%..%..%%%%%%
%.....%.%...%%%....%.......%
%%%....%....%....%%%....%%.%
%%....%.%.%...%.....%%%....%
%%%%x%%%%%%%%%%%%%%%%%%%%%%%