8,10
%%%%%%%%%%
%........%
%%.%.%.%%%
%....%...%
%.%.%.%%.%
e.%....%.%
%%%..%%%.x
%%%%%%%%%%