7,11
%e%%%%%%%%%
%...%.%...%
%.%.%.%.%%%
%.%.......%
%.%%%%.%%.%
%.%.....%.%
%%%%%%%%%x%